Offset      Modificação
------      -----------
003043ED     0C -> 00
00304482     0C -> 00
003044FD     0C -> 00
003044FE     0C -> 00
0030E39A     F1 -> FF
0030E39B     08 -> FF
0030E4C4     D3 -> FF
0030E4C5     00 -> FF
0030E5BA     F1 -> FF
0030E5BB     08 -> FF
0030E5BC     F2 -> FF
0030E5BD     08 -> FF
